ACGTTAGTCGCTTGAA-1
GTGGATTCAAGGGAGG-1
CCCACATCAGGTCTGC-1
TGGCCTTAGTCGTATC-1
AGGCGTCCAGCGTAGA-1
ACCGGGTTCCCAGCAG-1
TGTGTCCTCCATATCT-1
ATAGGCTGTACGAGAC-1
TTGTCTATCACGATTG-1
AGCCCGACACAATAAG-1
CGGACCACATCGCTAA-1